Name: ApartmentForSaleCollection
Source: http://www.njuskalo.hr/, advertisements website, scraped in August 2017
Description: 9162 observations, missing data is represented by the number zero
Created by: Mislav Jaksic, jaksicmislav@gmail.com

Variables
---------
Variables are divided into three groups: categorical, numerical and utility. Only categorical and numerical variables should effect the target variable.

Categorical variables
---------------------
Categorical variables have strings for values.

energyCertificate - apartment's energy certificate
floor - the number of floor or location in relation to the ground level
hasCargoElevator - does the apartment have a cargo elevator
hasElevator - does the apartment have an elevator
isNewlyBuilt - was the apartment built in the last few years
numberOfRooms - number of rooms
place - location, neighbourhood in a city or village in a rural area
state - location, equal to county in the United States
town - location, equal to municipality in the United States
type - in an apartment block or a house

Numerical variables
--------------------
Numerical variables have numbers for values.

numberOfParkingSpaces - the number of parking spaces that come with the purchase
priceInEuros - asking price in euros
size - living area in square meters
sizeOfBalcony - the size of the balcony that comes with the purchase
sizeOfGarden - the size of the garden that comes with the purchase
sizeOfTerrace - the size of the terrace that comes with the purchase
yearOfConstruction - the year of construction
yearOfLastAdaptation - the year of last refurbishment

Utility variables
------------------
Utility variables shouldn't effect the price of an apartment and instead exist to uniquely identify the observation.

_id - mongo database unique key
adCode - ad's unique value assigned by the ad website
adLink - ad link
adPublishedDate - the date and time at which the ad was published
objectCode - not clear what it represents
sellerLink - link to the publisher's personal web page
